Unnamed: 0,gender,race_ethnicity,parental_level_of_education,lunch,test_preparation_course,math_score,reading_score,writing_score,Total_score
100,male,group B,some college,standard,none,79,67,67,213
973,female,group D,some college,free/reduced,none,49,65,61,175
972,female,group A,high school,free/reduced,completed,53,50,60,163
423,female,group A,some high school,standard,completed,59,85,80,224
931,male,group D,some college,free/reduced,none,62,57,62,181
537,female,group D,high school,standard,none,51,66,62,179
683,female,group C,some high school,free/reduced,completed,29,40,44,113
389,male,group D,master's degree,standard,none,73,70,75,218
621,male,group B,bachelor's degree,free/reduced,none,62,63,56,181
218,male,group B,high school,free/reduced,none,66,77,70,213
67,female,group C,some college,standard,none,60,72,74,206
241,female,group E,bachelor's degree,standard,none,80,83,83,246
786,female,group E,some high school,free/reduced,none,72,79,77,228
48,female,group D,associate's degree,free/reduced,completed,57,74,76,207
641,female,group D,associate's degree,free/reduced,completed,74,88,90,252
908,female,group C,bachelor's degree,free/reduced,none,67,75,72,214
989,female,group D,some college,free/reduced,completed,67,86,83,236
777,female,group C,some college,free/reduced,none,35,44,43,122
184,male,group C,some high school,free/reduced,completed,45,52,49,146
879,female,group D,associate's degree,standard,none,64,76,74,214
885,female,group C,associate's degree,standard,completed,62,76,80,218
350,female,group B,bachelor's degree,standard,none,52,65,69,186
310,female,group B,associate's degree,standard,none,73,76,80,229
500,female,group D,master's degree,standard,none,74,79,82,235
430,male,group C,associate's degree,free/reduced,none,64,66,59,189
668,male,group C,some college,standard,none,73,74,61,208
877,male,group C,some high school,standard,none,57,61,54,172
259,female,group C,master's degree,free/reduced,completed,65,81,81,227
723,male,group C,high school,standard,none,50,48,42,140
501,female,group B,associate's degree,standard,completed,94,87,92,273
2,female,group B,master's degree,standard,none,90,95,93,278
418,male,group D,some college,standard,none,68,59,62,189
27,female,group C,bachelor's degree,standard,none,67,69,75,211
909,male,group E,bachelor's degree,standard,completed,70,64,70,204
400,female,group C,some high school,standard,completed,59,54,67,180
953,male,group C,high school,standard,completed,58,52,54,164
151,male,group A,bachelor's degree,standard,none,77,67,68,212
342,female,group B,high school,standard,completed,69,76,74,219
945,female,group C,associate's degree,standard,none,54,61,58,173
499,male,group E,some college,standard,none,76,71,72,219
171,male,group E,some high school,standard,none,94,88,78,260
485,male,group C,high school,standard,none,70,74,71,215
248,female,group B,high school,standard,none,65,64,62,191
25,male,group A,master's degree,free/reduced,none,73,74,72,219
281,male,group D,high school,standard,none,45,48,46,139
126,male,group B,some high school,standard,none,72,68,67,207
383,female,group E,some high school,free/reduced,none,38,49,45,132
194,female,group C,master's degree,standard,completed,69,84,85,238
748,female,group C,bachelor's degree,free/reduced,none,50,60,59,169
449,male,group B,associate's degree,standard,none,81,73,72,226
654,female,group B,some high school,standard,none,73,79,79,231
653,female,group A,associate's degree,standard,completed,65,70,74,209
492,female,group C,some college,standard,none,83,83,90,256
890,female,group E,some college,standard,completed,86,85,91,262
887,male,group C,high school,free/reduced,none,54,72,59,185
795,female,group E,associate's degree,free/reduced,completed,57,68,73,198
670,female,group C,high school,free/reduced,none,66,76,68,210
731,male,group A,some high school,free/reduced,none,55,46,43,144
309,female,group D,high school,free/reduced,none,49,57,52,158
769,male,group A,some college,free/reduced,none,58,60,57,175
98,female,group D,some college,free/reduced,none,58,67,62,187
591,male,group A,some high school,standard,none,71,62,50,183
261,male,group C,some college,standard,completed,79,79,78,236
274,male,group B,some college,standard,completed,88,85,76,249
35,male,group E,associate's degree,standard,completed,81,81,79,241
221,male,group B,associate's degree,standard,none,87,85,73,245
509,female,group C,bachelor's degree,standard,none,86,92,87,265
489,male,group A,associate's degree,free/reduced,completed,79,82,82,243
147,male,group C,associate's degree,free/reduced,none,73,68,66,207
343,male,group D,associate's degree,standard,completed,67,72,67,206
971,male,group C,some high school,standard,completed,78,72,69,219
228,male,group A,some high school,free/reduced,none,68,72,64,204
438,male,group C,high school,standard,none,70,56,51,177
420,female,group C,associate's degree,free/reduced,completed,82,93,93,268
225,female,group E,master's degree,free/reduced,none,45,56,54,155
219,male,group B,some high school,standard,completed,61,56,56,173
895,female,group E,some high school,free/reduced,none,32,34,38,104
913,female,group C,bachelor's degree,free/reduced,completed,47,62,66,175
474,female,group B,associate's degree,standard,completed,90,90,91,271
886,female,group E,associate's degree,standard,completed,93,100,95,288
16,male,group C,high school,standard,none,88,89,86,263
129,female,group A,bachelor's degree,standard,none,51,49,51,151
42,female,group B,associate's degree,standard,none,53,58,65,176
897,female,group B,some high school,free/reduced,completed,63,78,79,220
65,male,group B,some high school,standard,none,67,64,61,192
901,female,group C,master's degree,standard,none,73,78,74,225
442,female,group A,some high school,free/reduced,none,59,73,69,201
453,male,group C,some college,free/reduced,none,65,58,49,172
63,female,group C,associate's degree,standard,none,69,80,71,220
272,female,group D,associate's degree,free/reduced,none,47,53,58,158
440,female,group C,some college,standard,completed,67,81,79,227
517,female,group E,some college,standard,completed,66,74,73,213
542,female,group C,associate's degree,standard,none,81,77,79,237
211,male,group C,some college,free/reduced,none,35,28,27,90
562,male,group C,bachelor's degree,standard,completed,96,90,92,278
470,female,group C,associate's degree,standard,completed,83,85,90,258
128,male,group D,master's degree,standard,none,82,82,74,238
363,female,group D,some high school,free/reduced,none,27,34,32,93
113,female,group D,some college,standard,none,51,58,54,163
182,female,group E,high school,standard,none,50,50,47,147
959,male,group C,high school,standard,none,75,81,71,227
750,male,group D,some high school,standard,completed,71,69,68,208
756,male,group D,some college,standard,none,55,58,52,165
131,male,group C,some high school,free/reduced,completed,53,37,40,130
157,male,group B,some college,free/reduced,none,60,60,60,180
791,female,group D,some college,free/reduced,none,60,66,70,196
364,male,group C,some college,standard,none,59,60,58,177
927,female,group D,high school,free/reduced,completed,65,61,71,197
108,female,group B,associate's degree,free/reduced,none,52,76,70,198
640,male,group D,high school,standard,none,41,52,51,144
141,female,group C,some college,free/reduced,none,59,62,64,185
483,male,group A,high school,standard,none,59,52,46,157
301,male,group D,some high school,free/reduced,none,56,54,52,162
589,female,group A,some high school,standard,none,48,66,65,179
663,female,group C,high school,standard,none,65,69,67,201
961,female,group D,some high school,free/reduced,none,48,54,53,155
196,male,group C,some high school,free/reduced,completed,59,69,65,193
761,female,group D,some high school,standard,none,48,58,54,160
516,female,group D,some college,standard,none,74,89,84,247
918,female,group C,associate's degree,standard,completed,57,77,80,214
348,male,group D,high school,free/reduced,none,75,74,66,215
153,male,group D,bachelor's degree,standard,none,54,49,47,150
308,female,group B,associate's degree,free/reduced,none,53,71,67,191
755,female,group E,associate's degree,standard,none,84,95,92,271
933,male,group C,bachelor's degree,free/reduced,completed,70,75,74,219
539,male,group A,associate's degree,standard,completed,97,92,86,275
393,male,group C,associate's degree,standard,completed,57,54,56,167
476,male,group E,bachelor's degree,standard,completed,76,62,66,204
60,male,group E,bachelor's degree,free/reduced,completed,79,74,72,225
852,female,group E,some college,standard,none,87,85,93,265
920,male,group D,high school,free/reduced,none,69,70,67,206
56,female,group E,associate's degree,standard,completed,82,85,86,253
958,female,group D,high school,standard,none,45,63,59,167
986,female,group C,associate's degree,standard,none,40,59,51,150
242,female,group D,high school,standard,none,56,52,55,163
950,male,group E,high school,standard,none,94,73,71,238
264,male,group D,high school,standard,none,76,73,68,217
801,male,group C,some high school,standard,completed,76,80,73,229
123,male,group D,high school,free/reduced,none,63,57,56,176
457,male,group D,associate's degree,free/reduced,none,53,54,48,155
82,male,group A,some college,free/reduced,completed,50,47,54,151
329,female,group B,some high school,standard,none,41,55,51,147
554,male,group E,associate's degree,standard,none,53,45,40,138
946,male,group B,high school,standard,none,82,82,80,244
71,male,group D,some college,standard,completed,63,55,63,181
494,female,group B,high school,standard,none,54,64,68,186
598,female,group D,high school,standard,none,69,77,73,219
201,female,group D,some college,free/reduced,none,65,81,77,223
694,female,group C,some high school,standard,none,49,63,56,168
481,female,group D,associate's degree,free/reduced,none,52,59,56,167
955,male,group E,associate's degree,standard,none,72,57,62,191
330,male,group C,high school,standard,none,71,60,61,192
638,male,group E,some college,standard,none,86,76,74,236
720,female,group C,some college,free/reduced,none,62,72,70,204
707,male,group C,some college,standard,none,66,59,52,177
595,female,group C,bachelor's degree,standard,completed,56,79,72,207
178,female,group B,master's degree,free/reduced,completed,52,70,62,184
765,female,group B,high school,standard,none,74,72,72,218
682,male,group B,high school,standard,none,62,55,54,171
210,male,group D,some high school,free/reduced,completed,80,79,79,238
980,female,group B,high school,free/reduced,none,8,24,23,55
479,male,group E,associate's degree,standard,none,76,71,67,214
120,female,group C,bachelor's degree,standard,completed,79,92,89,260
970,female,group D,bachelor's degree,standard,none,89,100,100,289
268,female,group D,associate's degree,standard,completed,88,92,95,275
384,female,group A,some high school,free/reduced,none,38,43,43,124
876,male,group D,some college,standard,none,81,82,84,247
644,male,group B,high school,standard,none,70,65,60,195
739,male,group C,high school,free/reduced,none,61,60,55,176
760,female,group C,high school,free/reduced,none,53,72,64,189
957,female,group D,master's degree,standard,none,92,100,100,292
209,female,group B,some college,free/reduced,none,58,61,66,185
782,female,group B,high school,free/reduced,completed,76,85,82,243
574,female,group E,high school,standard,none,74,81,71,226
568,male,group B,high school,free/reduced,none,63,48,47,158
305,male,group A,some college,standard,none,69,67,69,205
725,male,group E,some college,standard,completed,81,74,71,226
985,male,group A,high school,standard,none,57,51,54,162
564,male,group B,bachelor's degree,free/reduced,none,48,51,46,145
486,male,group D,some college,free/reduced,none,61,47,56,164
942,male,group C,high school,standard,none,81,66,64,211
497,female,group D,some college,free/reduced,completed,59,78,76,213
188,male,group B,some high school,free/reduced,none,48,52,45,145
532,male,group E,associate's degree,standard,completed,62,61,58,181
648,female,group B,high school,standard,none,50,53,55,158
966,male,group A,some high school,standard,completed,66,68,64,198
92,male,group C,high school,standard,none,71,79,71,221
177,female,group C,associate's degree,standard,completed,71,77,77,225
351,male,group E,some college,standard,none,66,57,52,175
948,male,group B,some high school,free/reduced,completed,49,50,52,151
133,female,group C,some college,standard,completed,75,81,84,240
546,female,group A,some high school,standard,completed,92,100,97,289
256,female,group C,associate's degree,free/reduced,none,64,73,68,205
463,female,group C,some college,free/reduced,none,77,90,91,258
4,male,group C,some college,standard,none,76,78,75,229
688,male,group A,high school,free/reduced,none,53,58,44,155
88,female,group A,some college,standard,none,58,70,67,195
951,female,group D,some college,standard,completed,75,77,83,235
345,female,group C,high school,standard,none,72,80,75,227
984,female,group C,some high school,standard,none,74,75,82,231
181,female,group C,some college,free/reduced,none,46,64,66,176
579,female,group D,master's degree,standard,none,53,61,68,182
847,male,group D,high school,standard,none,64,54,50,168
747,male,group C,some college,standard,none,69,64,68,201
7,male,group B,some college,free/reduced,none,40,43,39,122
397,female,group C,associate's degree,standard,none,85,89,95,269
205,male,group D,some high school,standard,completed,74,71,78,223
226,female,group C,some college,standard,none,72,72,71,215
307,male,group C,some high school,standard,none,51,52,44,147
922,male,group D,high school,standard,none,72,66,66,204
394,female,group C,some high school,standard,completed,65,74,77,216
914,female,group B,associate's degree,free/reduced,none,46,61,55,162
263,female,group E,high school,standard,none,99,93,90,282
28,male,group C,high school,standard,none,70,70,65,205
200,female,group C,associate's degree,standard,completed,67,84,86,237
54,female,group C,some high school,free/reduced,completed,71,84,87,242
807,female,group E,high school,free/reduced,none,41,45,40,126
789,female,group C,master's degree,free/reduced,none,52,65,61,178
690,female,group C,associate's degree,standard,none,49,53,53,155
658,female,group D,associate's degree,free/reduced,none,43,60,58,161
107,male,group E,associate's degree,standard,completed,66,63,64,193
77,male,group A,bachelor's degree,standard,completed,80,78,81,239
482,male,group C,some college,free/reduced,none,68,68,61,197
624,female,group E,bachelor's degree,free/reduced,none,61,58,62,181
805,male,group A,some college,free/reduced,none,75,81,74,230
20,male,group D,high school,standard,none,66,69,63,198
143,male,group A,high school,standard,none,57,43,47,147
956,male,group C,some college,standard,none,84,87,81,252
15,female,group C,some high school,standard,none,69,75,78,222
44,female,group E,associate's degree,free/reduced,none,50,56,54,160
921,female,group C,high school,free/reduced,none,35,53,46,134
125,female,group B,high school,standard,none,87,95,86,268
588,female,group C,some college,standard,none,54,64,65,183
698,female,group D,associate's degree,standard,completed,57,78,79,214
749,male,group B,some college,standard,completed,87,84,86,257
798,male,group E,some college,standard,none,69,60,54,183
511,male,group A,some high school,standard,none,64,50,43,157
112,male,group A,associate's degree,standard,none,54,53,47,154
714,female,group B,some high school,standard,completed,60,70,74,204
724,male,group B,some college,standard,none,47,43,41,131
427,male,group C,some high school,free/reduced,none,69,71,65,205
848,female,group C,high school,standard,none,59,72,68,199
709,female,group D,associate's degree,free/reduced,completed,42,61,58,161
770,male,group B,high school,standard,none,52,48,49,149
402,female,group A,some college,free/reduced,none,49,65,55,169
978,male,group D,high school,standard,completed,55,41,48,144
223,male,group D,some high school,standard,none,86,80,75,241
716,male,group C,associate's degree,standard,completed,73,78,72,223
114,female,group E,bachelor's degree,standard,completed,99,100,100,299
324,female,group C,high school,free/reduced,none,41,46,43,130
633,female,group C,high school,standard,none,75,88,85,248
294,male,group D,high school,free/reduced,completed,78,77,80,235
23,female,group C,some high school,standard,none,69,73,73,215
258,female,group B,some college,standard,none,70,75,78,223
502,male,group C,some college,free/reduced,none,63,61,54,178
585,female,group C,associate's degree,standard,none,65,76,76,217
89,female,group D,some high school,standard,none,73,86,82,241
849,male,group D,associate's degree,standard,none,80,75,69,224
168,female,group B,high school,standard,completed,68,83,78,229
93,male,group C,associate's degree,free/reduced,completed,43,45,50,138
447,male,group C,high school,standard,completed,86,81,80,247
336,male,group D,some high school,standard,completed,76,70,69,215
695,female,group D,some college,free/reduced,none,79,89,86,254
68,male,group B,associate's degree,free/reduced,none,61,58,56,175
273,female,group D,some college,standard,none,65,70,71,206
115,male,group C,high school,standard,none,84,77,74,235
212,female,group C,high school,free/reduced,none,42,62,60,164
432,male,group C,high school,standard,none,61,56,55,172
266,female,group C,bachelor's degree,standard,none,63,75,81,219
321,female,group E,high school,standard,none,75,86,79,240
645,female,group B,bachelor's degree,standard,completed,65,81,81,227
514,female,group B,master's degree,free/reduced,completed,77,97,94,268
767,male,group B,high school,standard,completed,76,62,60,198
452,female,group C,associate's degree,free/reduced,none,65,77,74,216
271,male,group C,some college,standard,none,58,49,42,149
121,male,group B,associate's degree,standard,completed,91,89,92,272
26,male,group B,some college,standard,none,69,54,55,178
545,male,group E,some high school,free/reduced,completed,78,83,80,241
213,male,group C,associate's degree,free/reduced,completed,60,51,56,167
686,male,group E,some college,standard,completed,85,75,68,228
666,female,group C,some college,free/reduced,completed,63,73,71,207
754,male,group C,associate's degree,free/reduced,none,58,55,53,166
840,female,group D,high school,free/reduced,none,39,52,46,137
679,male,group D,some college,free/reduced,none,63,61,60,184
613,female,group C,associate's degree,standard,none,65,77,74,216
135,male,group C,bachelor's degree,standard,none,58,55,48,161
313,female,group C,associate's degree,free/reduced,completed,68,67,69,204
318,male,group B,bachelor's degree,standard,none,63,71,69,203
13,male,group A,some college,standard,completed,78,72,70,220
880,male,group C,bachelor's degree,standard,completed,63,64,66,193
697,female,group A,bachelor's degree,standard,none,59,72,70,201
156,female,group E,high school,free/reduced,completed,66,74,78,218
710,male,group C,some college,standard,completed,93,84,90,267
737,female,group B,some college,free/reduced,completed,53,66,73,192
615,female,group C,high school,standard,none,60,68,72,200
66,male,group D,some high school,free/reduced,none,45,37,37,119
586,female,group A,high school,standard,none,55,73,73,201
680,female,group D,high school,standard,none,67,72,74,213
587,female,group C,bachelor's degree,free/reduced,none,44,63,62,169
79,female,group E,master's degree,standard,none,62,68,68,198
812,female,group C,master's degree,standard,completed,54,64,67,185
475,female,group D,bachelor's degree,standard,completed,71,76,83,230
391,female,group D,some college,standard,none,77,68,77,222
810,male,group A,some high school,standard,none,51,31,36,118
916,male,group E,bachelor's degree,standard,completed,100,100,100,300
772,female,group B,some high school,free/reduced,completed,52,67,72,191
701,female,group B,some high school,standard,none,57,67,72,196
561,female,group C,some college,standard,none,63,74,74,211
533,female,group E,associate's degree,standard,completed,79,88,94,261
139,male,group D,some college,standard,completed,71,61,69,201
195,male,group D,associate's degree,standard,none,61,55,52,168
18,male,group C,master's degree,free/reduced,completed,46,42,46,134
276,female,group C,some high school,standard,completed,85,92,93,270
855,female,group B,bachelor's degree,standard,none,97,97,96,290
982,male,group B,some high school,standard,completed,79,85,86,250
818,female,group B,high school,free/reduced,none,60,72,68,200
236,male,group D,bachelor's degree,free/reduced,none,63,66,67,196
304,female,group C,associate's degree,standard,completed,74,75,83,232
541,male,group D,associate's degree,free/reduced,completed,79,82,80,241
326,male,group C,some college,standard,none,61,61,62,184
612,male,group C,bachelor's degree,standard,completed,94,90,91,275
825,male,group C,high school,standard,none,62,67,58,187
414,female,group C,bachelor's degree,free/reduced,completed,51,72,79,202
387,female,group C,associate's degree,free/reduced,none,57,78,67,202
730,female,group B,associate's degree,free/reduced,completed,68,77,80,225
558,female,group B,associate's degree,free/reduced,none,53,70,70,193
312,male,group D,bachelor's degree,standard,completed,67,61,68,196
894,female,group E,associate's degree,standard,none,59,62,69,190
742,female,group C,high school,standard,none,81,84,82,247
576,male,group A,some college,standard,completed,61,51,52,164
771,male,group D,bachelor's degree,standard,none,75,73,74,222
672,female,group C,some college,standard,none,69,78,76,223
137,male,group E,high school,standard,none,70,55,56,181
643,female,group E,high school,standard,completed,74,79,80,233
830,female,group A,some college,free/reduced,none,61,60,57,178
752,male,group C,master's degree,free/reduced,completed,79,77,75,231
109,female,group B,some high school,standard,none,70,64,72,206
863,female,group C,some college,standard,completed,71,71,80,222
288,male,group B,bachelor's degree,free/reduced,none,88,75,76,239
512,male,group D,some high school,free/reduced,none,62,49,52,163
507,male,group B,bachelor's degree,free/reduced,none,55,59,54,168
965,female,group D,some college,standard,none,62,70,72,204
700,female,group E,bachelor's degree,standard,completed,79,81,82,242
459,male,group B,high school,standard,completed,72,65,68,205
677,female,group C,some high school,standard,completed,70,82,76,228
703,female,group D,some college,standard,none,63,64,67,194
404,female,group C,high school,standard,none,54,59,62,175
684,male,group B,some college,standard,completed,62,66,68,196
681,male,group B,high school,standard,none,60,68,60,188
651,female,group A,high school,standard,completed,68,80,76,224
9,female,group B,high school,free/reduced,none,38,60,50,148
997,female,group C,high school,free/reduced,completed,59,71,65,195
949,female,group E,high school,free/reduced,completed,57,75,73,205
422,female,group D,master's degree,free/reduced,completed,47,58,67,172
566,female,group E,bachelor's degree,free/reduced,completed,92,100,100,292
247,female,group B,high school,standard,completed,58,70,68,196
759,male,group B,some college,standard,completed,69,77,77,223
445,female,group C,some high school,standard,completed,67,74,77,218
355,female,group B,bachelor's degree,standard,none,61,72,70,203
577,female,group B,high school,standard,none,81,91,89,261
900,male,group D,master's degree,standard,none,85,84,89,258
167,female,group B,master's degree,free/reduced,completed,58,76,78,212
859,male,group C,associate's degree,free/reduced,none,87,73,72,232
468,female,group A,high school,free/reduced,completed,77,88,85,250
466,female,group D,associate's degree,free/reduced,none,26,31,38,95
282,female,group D,bachelor's degree,free/reduced,none,73,79,84,236
785,female,group B,some high school,standard,completed,32,51,44,127
578,female,group B,some college,free/reduced,completed,48,56,58,162
187,male,group D,some high school,standard,completed,62,66,68,196
994,male,group A,high school,standard,none,63,63,62,188
87,female,group D,associate's degree,standard,none,71,71,74,216
444,male,group A,some high school,free/reduced,none,79,82,73,234
809,male,group B,bachelor's degree,standard,none,59,54,51,164
817,male,group D,bachelor's degree,free/reduced,completed,61,70,76,207
214,male,group E,high school,standard,completed,87,91,81,259
814,female,group C,high school,standard,none,72,80,83,235
138,female,group C,associate's degree,standard,none,59,66,67,192
284,female,group B,some high school,standard,none,37,46,46,129
17,female,group B,some high school,free/reduced,none,18,32,28,78
800,male,group C,some high school,standard,completed,67,73,68,208
693,female,group D,associate's degree,standard,none,77,77,73,227
275,male,group C,bachelor's degree,standard,none,83,78,73,234
40,male,group C,associate's degree,free/reduced,none,55,61,54,170
597,male,group A,some high school,standard,none,53,54,48,155
850,male,group C,master's degree,standard,none,71,67,67,205
646,female,group D,associate's degree,standard,none,59,70,65,194
519,female,group B,high school,free/reduced,completed,67,78,79,224
250,male,group A,some high school,standard,completed,47,49,49,145
968,female,group E,associate's degree,standard,none,68,76,67,211
22,male,group D,some college,standard,none,44,54,53,151
372,male,group D,some high school,standard,none,74,74,72,220
838,male,group B,associate's degree,free/reduced,completed,58,57,53,168
604,male,group D,master's degree,free/reduced,completed,84,89,90,263
828,female,group D,some high school,free/reduced,completed,69,86,81,236
504,female,group D,master's degree,free/reduced,none,40,59,54,153
639,female,group D,associate's degree,standard,none,76,74,73,223
779,male,group E,associate's degree,standard,completed,94,85,82,261
403,female,group D,high school,standard,completed,88,99,100,287
380,female,group B,associate's degree,standard,none,80,86,83,249
705,male,group A,bachelor's degree,free/reduced,none,62,72,65,199
699,male,group C,high school,free/reduced,none,66,66,59,191
826,female,group C,associate's degree,free/reduced,completed,56,68,70,194
244,male,group D,some high school,standard,none,75,74,69,218
144,male,group D,some college,standard,none,88,73,78,239
220,female,group D,high school,standard,completed,56,68,74,198
311,male,group B,bachelor's degree,standard,none,66,60,57,183
122,female,group C,some college,standard,completed,88,93,93,274
866,male,group C,high school,free/reduced,none,59,53,52,164
417,male,group C,associate's degree,standard,none,74,73,67,214
292,male,group C,some high school,standard,completed,63,60,57,180
833,female,group B,high school,standard,completed,77,82,89,248
963,female,group C,some high school,free/reduced,completed,65,76,75,216
215,male,group B,some high school,standard,completed,84,83,75,242
794,female,group B,high school,standard,none,42,52,51,145
235,male,group D,associate's degree,standard,none,80,75,77,232
780,female,group D,associate's degree,free/reduced,none,46,56,57,159
110,female,group D,associate's degree,free/reduced,completed,77,89,98,264
338,female,group B,some high school,free/reduced,none,24,38,27,89
555,female,group C,some college,free/reduced,none,32,39,33,104
868,male,group E,associate's degree,free/reduced,completed,78,74,72,224
625,male,group D,some college,standard,completed,100,97,99,296
854,male,group C,some high school,standard,none,62,64,55,181
374,female,group D,bachelor's degree,standard,none,59,70,73,202
53,male,group D,high school,standard,none,88,78,75,241
169,female,group C,some college,free/reduced,completed,67,75,70,212
424,male,group B,some college,free/reduced,none,41,39,34,114
567,female,group D,master's degree,free/reduced,completed,61,71,78,210
741,female,group A,associate's degree,free/reduced,none,37,57,56,150
732,female,group C,some college,standard,completed,87,89,94,270
862,male,group D,bachelor's degree,free/reduced,completed,39,42,38,119
488,male,group B,some high school,standard,completed,64,53,57,174
155,female,group C,some college,standard,completed,70,89,88,247
81,male,group B,high school,free/reduced,none,49,45,45,139
11,male,group D,associate's degree,standard,none,40,52,43,135
38,female,group D,associate's degree,free/reduced,completed,75,90,88,253
493,female,group C,bachelor's degree,standard,none,81,88,90,259
808,male,group C,high school,standard,none,90,75,69,234
396,female,group B,high school,free/reduced,none,50,67,63,180
977,male,group C,associate's degree,standard,none,62,65,58,185
461,male,group B,some college,free/reduced,none,54,54,45,153
523,male,group C,master's degree,free/reduced,none,54,59,50,163
634,male,group D,some high school,standard,none,84,84,80,248
722,female,group B,some high school,free/reduced,completed,74,90,88,252
851,female,group A,high school,standard,none,61,68,63,192
86,female,group C,some college,free/reduced,none,76,83,88,247
635,male,group A,high school,standard,none,71,74,64,209
671,male,group D,associate's degree,free/reduced,none,52,57,50,159
751,male,group E,some college,standard,none,68,72,65,205
675,female,group B,some college,standard,completed,50,64,66,180
140,female,group D,some high school,standard,none,76,72,71,219
704,female,group B,some high school,free/reduced,completed,59,63,64,186
495,male,group D,high school,standard,completed,68,64,66,198
377,female,group D,master's degree,free/reduced,completed,85,95,100,280
892,female,group A,master's degree,free/reduced,none,50,67,73,190
58,male,group D,some college,standard,completed,58,59,58,175
286,male,group E,associate's degree,standard,completed,97,82,88,267
819,female,group C,some high school,standard,none,77,91,88,256
522,male,group D,bachelor's degree,standard,none,69,58,57,184
656,male,group C,associate's degree,free/reduced,none,77,67,64,208
127,male,group D,some college,standard,completed,65,77,74,216
14,female,group A,master's degree,standard,none,50,53,58,161
31,female,group B,some college,standard,none,63,65,61,189
535,female,group C,bachelor's degree,free/reduced,completed,66,83,83,232
413,male,group B,some high school,standard,completed,63,67,67,197
346,male,group B,some college,standard,none,62,61,57,180
411,male,group E,some college,standard,completed,84,83,78,245
572,female,group C,some college,standard,none,53,62,56,171
548,female,group C,high school,free/reduced,none,62,67,64,193
70,female,group D,some college,free/reduced,completed,58,63,73,194
678,male,group D,associate's degree,free/reduced,none,81,75,78,234
906,male,group B,high school,standard,none,57,48,51,156
245,male,group C,associate's degree,standard,none,85,76,71,232
401,male,group A,some college,standard,none,53,43,43,139
409,male,group D,associate's degree,standard,completed,87,84,85,256
505,female,group B,some high school,standard,none,82,82,80,244
903,female,group D,bachelor's degree,free/reduced,completed,93,100,100,293
650,male,group C,some high school,free/reduced,completed,51,56,53,160
465,female,group C,some college,standard,none,84,87,91,262
713,male,group D,master's degree,standard,none,81,81,84,246
923,female,group B,associate's degree,free/reduced,none,54,65,65,184
172,female,group D,some college,standard,none,79,86,81,246
547,male,group C,high school,standard,completed,72,67,64,203
283,female,group D,some college,free/reduced,completed,70,78,78,226
162,male,group B,master's degree,free/reduced,none,49,53,52,154
134,male,group D,bachelor's degree,free/reduced,completed,74,79,75,228
647,female,group E,high school,free/reduced,none,64,62,68,194
853,male,group E,some high school,standard,none,82,67,61,210
669,male,group D,associate's degree,standard,completed,81,72,77,230
362,female,group C,some college,standard,none,52,58,58,168
596,male,group B,high school,free/reduced,none,30,24,15,69
606,female,group C,associate's degree,standard,none,85,84,82,251
332,male,group E,associate's degree,standard,completed,62,56,53,171
590,male,group C,some college,free/reduced,none,58,57,54,169
865,male,group D,some college,standard,completed,82,82,88,252
238,male,group B,some college,standard,none,54,52,51,157
76,male,group E,some high school,standard,none,30,26,22,78
744,male,group B,some college,free/reduced,none,55,55,47,157
136,male,group B,some high school,standard,completed,51,54,41,146
80,female,group B,associate's degree,standard,none,47,49,50,146
192,female,group B,some high school,standard,none,62,64,66,192
142,female,group E,some college,free/reduced,completed,42,55,54,151
925,male,group E,some high school,standard,completed,74,64,60,198
487,female,group C,associate's degree,free/reduced,none,60,75,74,209
103,male,group B,high school,standard,completed,60,44,47,151
360,female,group B,high school,standard,none,58,62,59,179
799,female,group C,associate's degree,standard,none,52,55,57,164
265,male,group D,some high school,free/reduced,none,59,42,41,142
912,female,group C,bachelor's degree,standard,completed,52,61,66,179
872,male,group B,associate's degree,standard,completed,82,84,78,244
491,female,group C,associate's degree,standard,none,64,64,70,198
618,male,group D,master's degree,standard,none,95,81,84,260
8,male,group D,high school,free/reduced,completed,64,64,67,195
935,male,group D,some college,free/reduced,none,70,63,58,191
883,male,group D,bachelor's degree,free/reduced,none,55,46,44,145
711,female,group E,some high school,standard,completed,80,85,85,250
366,male,group C,high school,standard,completed,69,58,53,180
446,male,group D,some college,free/reduced,none,69,66,60,195
239,male,group C,associate's degree,standard,none,84,80,80,244
217,female,group C,high school,free/reduced,none,34,42,39,115
349,male,group E,associate's degree,standard,none,87,74,76,237
660,male,group C,some college,free/reduced,none,74,77,73,224
34,male,group E,some college,standard,none,97,87,82,266
569,male,group D,bachelor's degree,free/reduced,none,68,68,67,203
462,female,group E,some college,standard,none,71,70,76,217
608,female,group E,some college,standard,none,61,64,62,187
443,female,group B,associate's degree,standard,none,73,83,76,232
655,female,group B,some college,standard,none,62,67,67,196
368,female,group A,some high school,free/reduced,none,44,64,58,166
932,male,group D,associate's degree,free/reduced,completed,61,71,73,205
967,male,group C,some college,standard,none,63,63,60,186
926,male,group E,associate's degree,free/reduced,none,64,56,52,172
412,male,group D,associate's degree,standard,none,71,66,60,197
510,male,group D,some college,standard,none,76,71,73,220
858,male,group B,high school,standard,completed,52,49,46,147
802,female,group E,associate's degree,standard,none,87,94,95,276
251,female,group D,some college,free/reduced,none,71,83,83,237
306,male,group E,some college,standard,completed,99,87,81,267
173,female,group C,associate's degree,standard,none,63,67,70,200
975,female,group C,some college,standard,completed,64,82,77,223
45,male,group B,associate's degree,standard,none,65,54,57,176
3,male,group A,associate's degree,free/reduced,none,47,57,44,148
528,female,group D,bachelor's degree,free/reduced,none,29,41,47,117
148,female,group D,bachelor's degree,standard,completed,68,75,81,224
297,male,group E,associate's degree,standard,completed,71,74,68,213
757,male,group E,bachelor's degree,free/reduced,completed,70,68,72,210
503,female,group E,associate's degree,standard,completed,95,89,92,276
702,male,group A,bachelor's degree,standard,completed,87,84,87,258
712,female,group D,some college,standard,none,98,100,99,297
891,female,group E,associate's degree,standard,none,85,92,85,262
979,female,group C,associate's degree,standard,none,91,95,94,280
938,male,group D,some college,standard,completed,85,81,85,251
529,female,group C,associate's degree,standard,none,62,74,70,206
189,female,group C,bachelor's degree,standard,none,77,88,87,252
291,male,group D,some high school,standard,none,86,73,70,229
998,female,group D,some college,standard,completed,68,78,77,223
746,male,group D,high school,standard,none,69,75,71,215
320,female,group C,high school,free/reduced,completed,67,79,84,230
659,male,group D,associate's degree,standard,none,90,87,85,262
197,male,group E,high school,free/reduced,none,55,56,51,162
419,male,group E,high school,free/reduced,completed,57,56,54,167
549,male,group C,master's degree,standard,none,79,72,69,220
792,male,group D,high school,free/reduced,none,66,74,69,209
90,female,group C,bachelor's degree,standard,none,65,72,74,211
365,male,group A,bachelor's degree,free/reduced,completed,49,58,60,167
59,female,group C,some high school,free/reduced,none,0,17,10,27
717,female,group C,associate's degree,standard,completed,96,96,99,291
775,female,group B,some high school,free/reduced,none,49,58,55,162
202,male,group C,associate's degree,standard,none,69,77,69,215
344,male,group D,some college,standard,none,79,73,67,219
352,female,group C,some college,standard,completed,63,78,80,221
176,female,group B,high school,free/reduced,completed,46,54,58,158
398,male,group B,some high school,standard,none,74,63,57,194
632,female,group B,bachelor's degree,standard,completed,66,74,81,221
252,female,group B,some high school,standard,completed,60,70,70,200
580,female,group D,some high school,standard,none,81,97,96,274
937,female,group E,high school,free/reduced,none,57,58,57,172
924,male,group D,high school,free/reduced,none,74,70,69,213
339,female,group D,some high school,free/reduced,completed,35,55,60,150
620,female,group C,high school,free/reduced,none,35,61,54,150
857,female,group C,bachelor's degree,standard,none,65,79,81,225
623,male,group A,some college,standard,completed,100,96,86,282
905,male,group D,some college,standard,none,88,77,77,242
783,female,group C,associate's degree,standard,completed,52,59,62,173
267,female,group D,high school,standard,none,69,72,77,218
298,male,group C,high school,free/reduced,completed,40,46,50,136
480,male,group B,high school,standard,completed,73,71,68,212
743,female,group C,associate's degree,standard,completed,59,73,72,204
911,female,group A,some college,standard,none,69,84,82,235
657,male,group D,some high school,standard,none,69,66,61,196
821,female,group D,bachelor's degree,free/reduced,none,78,90,93,261
373,female,group D,some college,standard,completed,82,97,96,275
24,male,group D,bachelor's degree,free/reduced,completed,74,71,80,225
83,male,group E,associate's degree,standard,none,72,64,63,199
610,male,group D,some college,free/reduced,completed,69,60,63,192
385,female,group E,some college,standard,none,67,76,75,218
995,female,group E,master's degree,standard,completed,88,99,95,282
180,male,group C,master's degree,free/reduced,completed,62,68,75,205
285,male,group B,associate's degree,standard,completed,81,82,82,245
875,male,group C,some college,free/reduced,none,80,64,66,210
317,male,group C,associate's degree,standard,none,83,72,78,233
379,male,group A,bachelor's degree,standard,none,66,64,62,192
224,female,group B,associate's degree,standard,completed,52,66,73,191
57,male,group D,associate's degree,standard,none,52,55,49,156
356,male,group A,associate's degree,standard,none,63,61,61,185
962,female,group E,associate's degree,standard,none,100,100,100,300
832,male,group A,bachelor's degree,standard,none,64,60,58,182
193,male,group D,some college,standard,completed,77,62,62,201
378,female,group A,some high school,standard,none,71,83,77,231
764,male,group D,some college,standard,none,60,63,59,182
78,female,group D,some high school,standard,completed,61,74,72,207
289,male,group E,some high school,standard,completed,77,76,77,230
893,male,group D,some high school,standard,completed,88,74,75,237
240,male,group D,high school,free/reduced,completed,73,68,66,207
6,female,group B,some college,standard,completed,88,95,92,275
996,male,group C,high school,free/reduced,none,62,55,55,172
565,male,group B,associate's degree,standard,none,48,43,45,136
95,male,group C,associate's degree,free/reduced,completed,78,81,82,241
934,male,group C,associate's degree,standard,completed,98,87,90,275
33,male,group D,some college,standard,none,40,42,38,120
781,female,group B,master's degree,standard,none,77,90,84,251
10,male,group C,associate's degree,standard,none,58,54,52,164
508,male,group C,master's degree,standard,none,79,78,77,234
91,male,group C,high school,free/reduced,none,27,34,36,97
30,female,group D,some college,standard,none,69,74,74,217
822,male,group E,some college,free/reduced,completed,49,52,51,152
829,male,group B,some high school,standard,none,68,54,53,175
889,male,group D,high school,free/reduced,none,44,51,48,143
303,male,group B,associate's degree,standard,none,80,76,64,220
944,female,group B,high school,standard,none,58,68,61,187
460,male,group C,bachelor's degree,free/reduced,none,53,58,55,166
0,female,group B,bachelor's degree,standard,none,72,72,74,218
990,male,group E,high school,free/reduced,completed,86,81,75,242
727,male,group E,some high school,standard,completed,68,51,57,176
556,female,group C,associate's degree,standard,completed,55,72,79,206
191,male,group D,some college,standard,completed,76,83,79,238
208,female,group B,some college,free/reduced,none,74,81,76,231
331,male,group C,associate's degree,standard,none,47,37,35,119
249,male,group C,high school,standard,none,68,60,53,181
61,male,group A,some high school,free/reduced,none,39,39,34,112
873,male,group E,associate's degree,free/reduced,none,90,90,82,262
552,female,group B,associate's degree,standard,none,40,48,50,138
290,male,group C,associate's degree,standard,none,76,70,68,214
846,male,group C,master's degree,standard,completed,91,85,85,261
665,female,group C,some high school,free/reduced,completed,50,60,60,170
827,female,group C,some high school,standard,none,65,69,76,210
592,male,group E,bachelor's degree,standard,none,68,68,64,200
62,male,group A,associate's degree,free/reduced,none,62,61,55,178
551,male,group B,bachelor's degree,free/reduced,completed,87,90,88,265
279,male,group B,bachelor's degree,free/reduced,none,73,56,57,186
199,female,group B,bachelor's degree,free/reduced,none,78,79,76,233
416,male,group C,bachelor's degree,standard,completed,71,74,68,213
804,female,group C,some college,standard,none,73,76,78,227
185,male,group C,associate's degree,free/reduced,completed,65,67,65,197
146,male,group B,some high school,standard,none,88,84,75,247
629,female,group C,some high school,standard,completed,44,51,55,150
652,female,group D,some college,standard,completed,85,86,98,269
793,male,group E,some high school,standard,completed,89,84,77,250
467,male,group A,high school,free/reduced,completed,72,67,65,204
987,male,group E,some high school,standard,completed,81,75,76,232
175,female,group C,master's degree,standard,completed,81,91,87,259
229,female,group C,some college,standard,completed,88,95,94,277
834,male,group B,some college,standard,none,58,50,45,153
367,male,group C,bachelor's degree,free/reduced,none,61,66,61,188
584,female,group D,some college,standard,none,69,77,77,223
607,female,group C,master's degree,free/reduced,none,40,58,54,152
341,female,group C,high school,standard,none,61,73,63,197
525,male,group E,some college,standard,none,68,60,59,187
410,female,group D,master's degree,standard,completed,70,71,74,215
581,female,group E,some high school,standard,none,77,79,80,236
484,female,group B,associate's degree,standard,none,49,52,54,155
262,female,group C,some high school,free/reduced,none,44,50,51,145
454,female,group C,associate's degree,free/reduced,none,53,61,62,176
231,male,group C,associate's degree,standard,none,46,43,42,131
448,male,group B,high school,standard,none,47,46,42,135
164,female,group E,master's degree,standard,none,81,92,91,264
960,female,group A,some college,standard,none,56,58,64,178
734,female,group E,some college,free/reduced,none,53,58,57,168
943,male,group A,some high school,free/reduced,completed,61,62,61,184
300,male,group A,some college,free/reduced,completed,81,78,81,240
359,female,group D,some college,standard,none,80,90,89,259
450,female,group C,some college,free/reduced,completed,64,85,85,234
118,female,group D,some high school,standard,none,51,63,61,175
405,female,group C,some high school,standard,none,63,73,68,204
381,male,group C,associate's degree,standard,completed,87,100,95,282
758,female,group D,some college,free/reduced,completed,52,59,65,176
429,male,group C,some high school,free/reduced,none,68,63,54,185
774,male,group B,some college,standard,none,66,65,60,191
293,female,group E,bachelor's degree,standard,none,65,73,75,213
815,male,group B,some high school,standard,completed,94,86,87,267
287,female,group B,some high school,standard,none,67,89,82,238
630,male,group D,some college,standard,none,67,64,70,201
896,male,group B,high school,free/reduced,none,36,29,27,92
183,female,group D,associate's degree,standard,none,65,69,70,204
407,female,group B,associate's degree,standard,none,82,80,77,239
991,female,group B,some high school,standard,completed,65,82,78,225
628,male,group D,some college,free/reduced,none,49,57,46,152
469,male,group C,some college,standard,none,91,74,76,241
439,male,group D,some high school,standard,completed,89,88,82,259
426,male,group C,bachelor's degree,standard,none,86,83,86,255
130,male,group D,master's degree,standard,none,89,84,82,255
437,male,group D,associate's degree,free/reduced,none,75,66,73,214
664,male,group D,associate's degree,standard,none,80,63,63,206
203,female,group B,associate's degree,standard,none,57,69,68,194
874,female,group C,bachelor's degree,free/reduced,none,43,62,61,166
685,female,group E,master's degree,standard,completed,94,99,100,293
936,male,group A,associate's degree,standard,none,67,57,53,177
96,male,group B,some high school,standard,completed,65,66,62,193
51,male,group E,associate's degree,free/reduced,completed,77,69,68,214
43,male,group B,some college,free/reduced,completed,59,65,66,190
543,female,group D,associate's degree,standard,none,82,95,89,266
357,female,group C,some college,free/reduced,completed,42,66,69,177
269,female,group E,some college,free/reduced,none,71,76,70,217
835,female,group C,high school,standard,completed,60,64,74,198
47,female,group C,high school,standard,none,66,71,76,213
813,male,group E,some high school,standard,completed,87,84,76,247
594,female,group C,bachelor's degree,standard,completed,92,100,99,291
55,female,group C,high school,free/reduced,none,33,41,43,117
106,female,group D,master's degree,standard,none,87,100,100,287
637,female,group D,some high school,standard,completed,80,92,88,260
204,male,group C,some college,standard,none,59,41,42,142
32,female,group E,master's degree,free/reduced,none,56,72,65,193
649,female,group D,some college,standard,completed,69,79,81,229
839,female,group C,associate's degree,standard,none,66,77,73,216
674,female,group D,high school,standard,completed,69,77,78,224
165,female,group C,bachelor's degree,standard,completed,96,100,100,296
735,male,group C,master's degree,standard,none,67,57,59,183
605,male,group C,some high school,standard,none,75,72,62,209
600,female,group D,master's degree,standard,none,54,60,63,177
323,female,group C,some high school,free/reduced,none,43,53,53,149
425,female,group C,some college,free/reduced,none,62,67,62,191
715,female,group B,associate's degree,free/reduced,completed,76,94,87,257
150,male,group A,some high school,standard,completed,62,67,69,198
526,male,group C,some high school,free/reduced,completed,56,61,60,177
531,female,group C,some high school,standard,none,47,54,53,154
386,female,group E,bachelor's degree,standard,none,64,73,70,207
696,female,group C,associate's degree,standard,completed,75,82,90,247
415,male,group E,high school,standard,none,84,73,69,226
860,female,group C,associate's degree,standard,none,53,62,53,168
21,female,group B,some college,free/reduced,completed,65,75,70,210
314,female,group C,bachelor's degree,standard,completed,59,64,75,198
370,male,group E,some college,standard,none,84,77,71,232
599,female,group D,some high school,standard,none,65,82,81,228
888,female,group D,some college,free/reduced,none,69,65,74,208
673,female,group C,associate's degree,standard,completed,65,84,84,233
964,male,group D,some college,standard,none,72,57,58,187
232,female,group B,bachelor's degree,standard,none,67,86,83,236
149,male,group E,associate's degree,free/reduced,completed,100,100,93,293
36,female,group D,associate's degree,standard,none,74,81,83,238
145,female,group C,some college,free/reduced,none,22,39,33,94
797,female,group E,associate's degree,free/reduced,none,70,84,81,235
159,male,group D,associate's degree,free/reduced,none,66,62,64,192
299,male,group D,associate's degree,free/reduced,none,90,87,75,252
983,female,group A,some college,standard,completed,78,87,91,256
39,male,group B,associate's degree,free/reduced,none,57,56,57,170
687,male,group D,associate's degree,free/reduced,none,77,78,73,228
315,male,group C,high school,standard,none,71,66,65,202
753,female,group C,some high school,standard,completed,77,90,85,252
882,female,group B,high school,free/reduced,none,64,73,71,208
399,male,group D,some high school,standard,none,60,59,54,173
844,female,group D,some high school,free/reduced,completed,40,65,64,169
19,female,group C,associate's degree,free/reduced,none,54,58,61,173
550,male,group C,some high school,free/reduced,none,79,76,65,220
974,female,group A,some college,standard,none,54,63,67,184
603,male,group D,high school,free/reduced,none,60,57,51,168
969,female,group B,bachelor's degree,standard,none,75,84,80,239
160,male,group B,associate's degree,free/reduced,completed,82,78,74,234
527,female,group C,high school,free/reduced,none,36,53,43,132
302,female,group C,associate's degree,standard,completed,67,84,81,232
498,female,group B,some high school,standard,none,66,69,68,203
881,female,group E,bachelor's degree,standard,completed,71,70,70,211
233,male,group E,some high school,standard,none,92,87,78,257
255,female,group E,some college,standard,none,62,73,70,205
811,male,group A,high school,free/reduced,none,45,47,49,141
428,male,group A,some high school,free/reduced,none,65,59,53,177
773,female,group C,bachelor's degree,free/reduced,none,62,78,79,219
395,male,group A,high school,free/reduced,none,48,45,41,134
766,female,group C,high school,standard,completed,58,75,77,210
823,female,group B,high school,free/reduced,none,71,87,82,240
521,female,group C,associate's degree,standard,none,91,86,84,261
216,female,group E,associate's degree,free/reduced,completed,83,86,88,257
464,male,group A,bachelor's degree,standard,completed,75,58,62,195
583,female,group D,associate's degree,standard,completed,73,75,80,228
520,male,group D,some college,standard,none,71,49,52,172
929,female,group C,some high school,free/reduced,none,48,56,51,155
842,female,group B,high school,free/reduced,completed,23,44,36,103
49,male,group C,high school,standard,completed,82,84,82,248
917,female,group C,high school,standard,none,44,61,52,157
179,female,group D,some high school,standard,completed,97,100,100,297
692,female,group C,bachelor's degree,free/reduced,completed,66,74,81,221
436,male,group D,associate's degree,standard,none,75,68,64,207
237,female,group D,some high school,standard,completed,64,60,74,198
845,male,group E,master's degree,standard,none,90,85,84,259
560,female,group D,some college,standard,completed,74,75,79,228
85,female,group C,some college,standard,none,73,80,82,235
609,female,group B,associate's degree,standard,none,58,63,65,186
207,male,group E,high school,standard,completed,81,80,76,237
152,female,group B,associate's degree,standard,completed,59,70,66,195
388,female,group D,high school,standard,none,62,64,64,190
347,female,group C,bachelor's degree,standard,completed,77,94,95,266
421,female,group D,high school,standard,completed,57,58,64,179
